11111111111111111111
10000000000000000001
10001111000111100001
10001C00000000100001
10001111111111100001
100000000000P0000001
10000011111110000001
100000CCCCCCC0000001
10000111111111000001
1000000001000E000001
10000000010000000001
10000000010000000001
10000000000000000001
11111111111111111111
10101010111111111111
11111111111111111111
